s,s,s,s,s,s,s,s,s,s,s,s,s,s,s,s,s,s,s,s,s,s,s,s,s,s,s,s,s,s,s,s,s,s,s,s,s,s,s,s,s,s,s,s,s,s,s,s,s,s,s,s,s,s,s,s,s,s,s,s,s,s,s,s,s,s,s,s,s,s,s,s,s,s,s,s,s,s,s,s
s,s,s,s,s,s,s,s,s,s,s,s,s,s,s,s,s,s,s,s,s,s,s,s,s,s,s,s,s,s,s,s,s,s,s,s,s,s,s,s,s,s,s,s,s,s,s,s,s,s,s,s,s,s,s,s,s,s,s,s,s,s,s,s,s,s,s,s,s,s,s,s,s,s,s,s,s,s,s,s
s,s,s,s,s,s,s,s,s,s,s,s,s,s,s,s,s,s,s,s,s,s,s,s,s,s,s,s,s,s,s,s,s,s,s,s,s,s,s,s,s,s,s,s,s,s,s,s,s,s,s,s,s,s,s,s,s,s,s,s,s,s,s,s,s,s,s,s,s,s,s,s,s,s,s,s,s,s,s,s
s,s,s,s,s,s,s,s,s,s,s,s,s,s,s,s,s,s,s,s,s,s,s,s,s,s,s,s,s,s,s,s,s,s,s,s,s,s,s,s,s,s,s,s,s,s,s,s,s,s,s,s,s,s,s,s,s,s,s,s,s,s,s,s,s,s,s,s,s,s,s,s,s,s,s,s,s,s,s,s
s,s,s,s,s,s,s,s,s,s,s,s,s,s,s,s,s,s,s,s,s,s,s,s,s,s,s,s,s,s,s,s,s,s,s,s,s,s,s,s,s,s,s,s,s,s,s,s,s,s,s,s,s,s,s,s,s,s,s,s,s,s,s,s,s,s,s,s,s,s,s,s,s,s,s,s,s,s,s,s
s,s,s,s,s,s,s,s,s,s,s,s,s,s,s,s,s,s,s,s,s,s,s,s,s,s,s,s,s,s,s,s,s,s,s,s,s,s,s,s,s,s,s,s,s,s,s,s,s,s,s,s,s,s,s,s,s,s,s,s,s,s,s,s,s,s,s,s,s,s,s,s,s,s,s,s,s,s,s,s
s,s,s,s,s,s,s,s,s,s,s,s,s,s,s,s,s,s,s,s,s,s,s,s,s,s,s,s,s,s,s,s,s,s,s,s,s,s,s,s,s,s,s,s,s,s,s,s,s,s,s,s,s,s,s,s,s,s,s,s,s,s,s,s,s,s,s,s,s,s,s,s,s,s,s,s,s,s,s,s
s,s,s,s,s,s,s,s,s,s,s,s,s,s,s,s,s,s,s,s,s,s,s,s,s,s,s,s,s,s,s,s,s,s,s,s,s,s,s,s,s,s,s,s,s,s,s,s,s,s,s,s,s,s,s,s,s,s,s,s,s,s,s,s,s,s,s,s,s,s,s,s,s,s,s,s,s,s,s,s
s,s,s,s,s,s,s,s,s,s,s,s,s,s,s,s,s,s,s,s,s,s,s,s,s,s,s,s,s,s,s,s,s,s,s,s,s,s,s,s,s,s,s,s,s,s,s,s,s,s,s,b,b,b,b,b,b,b,b,b,s,s,s,s,s,s,s,s,s,s,s,s,s,s,s,s,s,s,s,s
s,s,s,s,s,s,s,s,s,s,s,s,s,s,s,s,s,s,s,s,s,s,s,s,s,s,s,s,s,s,s,s,s,s,s,s,s,s,s,s,s,s,s,s,s,s,s,s,s,s,b,b,b,b,b,b,b,b,b,b,s,s,s,s,s,s,s,s,s,s,s,s,s,s,s,s,s,s,s,s
s,s,s,s,s,s,s,s,s,s,s,s,s,s,s,s,s,s,s,s,s,s,s,s,b,b,b,b,b,b,b,b,b,b,b,b,b,b,b,b,b,b,b,b,s,s,s,s,s,s,b,b,l,l,l,l,l,l,b,b,b,s,s,s,s,s,s,s,s,s,s,s,s,s,s,s,s,s,s,s
s,s,s,s,s,s,s,s,s,s,s,s,s,s,s,s,s,s,b,b,b,b,b,b,b,b,b,b,b,b,b,b,b,b,b,b,b,b,b,b,b,b,b,b,b,b,b,b,b,b,b,l,l,l,l,l,l,l,l,b,b,s,s,s,s,s,s,s,s,s,s,s,s,s,s,s,s,s,s,s
s,s,s,s,s,s,s,s,s,s,s,s,s,s,s,s,b,b,b,b,b,b,b,b,b,b,b,l,l,l,l,l,b,b,b,l,l,l,l,l,l,b,b,b,b,b,b,b,b,b,l,l,l,l,l,l,l,l,l,b,b,s,s,s,s,s,s,s,s,s,s,s,s,s,s,s,s,s,s,s
s,s,s,s,s,s,s,s,s,s,s,s,s,s,s,b,b,b,b,b,b,b,b,b,b,b,l,l,l,l,l,l,l,l,l,l,l,l,l,l,l,l,l,l,l,l,l,l,l,l,l,l,l,l,l,l,l,l,l,b,b,s,s,s,s,s,s,s,s,s,s,s,s,s,s,s,s,s,s,s
s,s,s,s,s,s,s,s,s,s,s,s,s,b,b,b,b,b,b,b,b,b,l,l,l,l,l,l,l,l,l,l,l,l,l,l,l,l,l,l,l,l,l,l,l,l,l,l,l,l,l,l,l,l,l,l,l,l,l,b,b,s,s,s,s,s,s,s,s,s,s,s,s,s,s,s,s,s,s,s
s,s,s,s,s,s,s,s,s,s,s,s,b,b,b,b,b,b,b,l,l,l,l,l,l,l,l,l,l,l,l,l,l,l,l,l,l,l,l,l,l,l,l,l,l,l,l,l,l,l,l,l,l,l,l,l,l,l,l,b,b,s,s,s,s,s,s,s,s,s,s,s,s,s,s,s,s,s,s,s
s,s,s,s,s,s,s,s,s,s,b,b,b,b,b,b,l,l,l,l,l,l,l,l,l,l,l,l,l,l,l,l,l,l,l,l,l,l,l,l,l,l,l,l,l,l,l,l,l,l,l,l,l,l,p,l,l,l,l,b,b,s,s,s,s,s,s,s,s,s,s,s,s,s,s,s,s,s,s,s
s,s,s,s,s,s,s,s,s,b,b,b,b,b,l,l,l,l,l,l,l,l,l,l,l,l,l,l,l,l,l,l,l,l,l,l,l,l,l,l,l,l,l,l,l,l,l,l,l,l,l,l,l,p,p,l,l,l,l,b,b,s,s,s,s,s,s,s,s,s,s,s,s,s,s,s,s,s,s,s
s,s,s,s,s,s,s,s,s,b,b,b,b,l,l,l,l,l,l,l,l,l,l,l,l,l,l,l,l,g,l,l,l,l,l,l,l,l,l,l,l,g,l,l,l,l,l,l,l,l,l,l,l,p,l,l,l,l,l,b,b,b,b,b,b,b,s,s,s,s,s,s,s,s,s,s,s,s,s,s
s,s,s,s,s,s,s,s,s,b,b,b,l,l,l,l,l,l,l,l,l,l,l,g,l,l,l,l,l,l,l,l,l,l,l,l,l,l,l,l,l,l,l,l,l,l,l,l,l,l,l,l,l,p,l,l,l,l,l,l,b,b,b,b,b,b,b,s,s,s,s,s,s,s,s,s,s,s,s,s
s,s,s,s,s,s,s,s,s,b,b,b,l,l,l,l,l,l,l,l,l,l,l,l,l,l,l,l,l,l,l,l,l,l,l,l,l,l,l,l,l,l,l,l,l,l,l,l,l,l,l,l,l,p,l,l,l,l,l,l,l,l,l,l,b,b,b,b,s,s,s,s,s,s,s,s,s,s,s,s
s,s,s,s,s,s,s,s,s,b,b,b,l,l,l,l,l,l,l,l,l,l,l,l,l,l,l,l,l,l,l,l,l,l,l,l,l,l,l,l,l,l,l,l,l,l,l,l,l,l,l,l,l,p,l,l,l,l,l,l,l,l,l,l,l,b,b,b,s,s,s,s,s,s,s,s,s,s,s,s
s,s,s,s,s,s,s,s,s,b,b,b,l,l,l,l,l,l,l,l,l,l,l,l,l,l,l,l,l,l,l,l,l,l,l,l,l,l,l,l,l,l,l,l,l,l,l,l,l,l,l,l,l,p,l,l,l,l,l,l,l,l,l,l,l,b,b,b,b,s,s,s,s,s,s,s,s,s,s,s
s,s,s,s,s,s,s,s,s,s,b,b,b,l,l,l,l,l,l,l,l,l,l,l,l,l,l,l,l,l,l,l,l,l,l,l,l,l,l,l,l,p,l,l,l,l,l,l,l,l,l,l,p,p,l,l,l,l,l,l,l,l,l,l,l,l,b,b,b,s,s,s,s,s,s,s,s,s,s,s
s,s,s,s,s,s,s,s,s,s,b,b,b,l,l,l,l,l,l,l,l,l,l,l,l,l,l,l,l,l,l,l,l,l,l,l,l,l,l,l,l,p,l,l,l,l,l,l,l,l,l,p,p,l,l,l,l,l,l,l,l,l,l,l,l,l,l,b,b,s,s,s,s,s,s,s,s,s,s,s
s,s,s,s,s,s,s,s,s,s,b,b,b,b,l,l,l,l,l,l,l,l,l,l,l,l,l,l,l,l,l,l,l,l,l,l,l,l,l,l,l,p,l,l,p,p,p,p,p,p,p,l,l,l,l,l,l,l,l,l,l,l,l,l,l,l,l,b,b,s,s,s,s,s,s,s,s,s,s,s
s,s,s,s,s,s,s,s,s,s,s,b,b,b,l,l,l,l,l,l,l,l,l,l,l,l,l,l,l,l,l,l,l,l,l,l,l,l,l,l,l,p,p,p,p,l,l,l,l,l,l,l,l,l,l,l,l,l,l,l,l,l,l,l,l,l,l,b,b,s,s,s,s,s,s,s,s,s,s,s
s,s,s,s,s,s,s,s,s,s,s,b,b,b,l,l,l,l,l,l,l,l,l,l,l,g,l,l,l,l,l,l,l,l,l,l,l,l,l,l,l,p,l,l,l,l,l,l,l,l,l,l,l,l,l,l,l,l,l,l,l,l,l,l,l,l,l,b,b,b,s,s,s,s,s,s,s,s,s,s
s,s,s,s,s,s,s,s,s,s,s,s,b,b,b,l,l,l,l,l,l,l,l,l,l,l,l,l,l,l,l,l,l,l,l,l,l,l,l,l,l,p,l,l,l,l,l,l,l,l,l,l,l,l,l,l,l,l,l,l,l,l,l,l,l,l,l,b,b,b,s,s,s,s,s,s,s,s,s,s
s,s,s,s,s,s,s,s,s,s,s,s,b,b,b,l,l,l,l,l,l,l,l,l,l,l,l,l,l,l,l,l,l,l,l,l,l,l,l,l,l,p,l,l,l,l,l,l,l,l,l,l,l,l,l,l,l,l,l,l,l,l,l,l,l,l,l,b,b,b,s,s,s,s,s,s,s,s,s,s
s,s,s,s,s,s,s,s,s,s,s,s,b,b,b,l,l,l,l,l,l,l,l,l,l,l,l,l,l,l,l,l,l,l,l,l,l,l,p,p,p,p,l,l,l,l,l,l,l,l,l,l,l,l,l,l,l,l,l,l,l,l,l,l,l,l,l,l,b,b,s,s,s,s,s,s,s,s,s,s
s,s,s,s,s,s,s,s,s,s,s,s,b,b,b,l,l,l,l,l,l,l,l,l,l,l,p,p,p,p,p,p,p,p,p,p,p,p,l,l,l,p,l,l,l,l,l,l,l,l,l,l,l,l,l,l,l,l,l,l,l,l,l,l,l,l,l,l,b,b,s,s,s,s,s,s,s,s,s,s
s,s,s,s,s,s,s,s,s,s,s,s,b,b,b,l,l,l,l,l,l,l,l,l,l,p,p,l,l,l,l,l,l,l,l,l,l,l,l,l,l,p,p,p,p,p,p,p,p,p,p,p,p,p,p,p,l,l,l,l,l,l,l,l,l,l,l,l,b,b,s,s,s,s,s,s,s,s,s,s
s,s,s,s,s,s,s,s,s,s,s,s,b,b,b,l,l,l,l,l,l,l,l,l,l,p,l,l,l,l,l,l,l,l,l,l,l,l,l,l,l,p,l,l,l,l,l,l,l,l,l,l,l,l,l,p,l,l,l,l,l,l,l,l,l,l,l,b,b,b,s,s,s,s,s,s,s,s,s,s
s,s,s,s,s,s,s,s,s,s,s,s,b,b,b,l,l,l,l,l,l,l,l,l,p,p,l,l,l,l,l,l,l,l,l,l,l,l,l,l,l,l,l,l,l,l,l,l,l,l,l,l,l,l,p,l,l,l,l,l,l,l,l,l,l,l,l,b,b,b,s,s,s,s,s,s,s,s,s,s
s,s,s,s,s,s,s,s,s,s,s,s,b,b,b,l,l,l,l,l,l,l,l,l,p,l,l,l,l,l,l,l,l,l,l,l,l,l,l,l,l,l,l,l,l,l,l,l,l,l,l,l,l,l,p,l,l,l,l,l,l,l,l,l,l,l,l,b,b,b,s,s,s,s,s,s,s,s,s,s
s,s,s,s,s,s,s,s,s,s,s,s,b,b,b,l,l,l,l,l,l,l,l,l,p,l,l,l,l,l,l,l,l,l,l,l,l,l,l,l,l,l,l,l,l,l,l,l,l,l,l,l,l,l,p,l,l,l,l,l,l,l,l,l,l,l,l,b,b,b,s,s,s,s,s,s,s,s,s,s
s,s,s,s,s,s,s,s,s,s,s,s,s,b,b,l,l,l,l,l,l,l,l,l,p,l,l,l,l,l,l,l,l,l,l,l,l,l,l,l,l,l,l,l,l,l,l,l,l,l,l,l,l,l,p,l,l,l,l,l,l,l,l,l,l,l,l,l,b,b,b,s,s,s,s,s,s,s,s,s
s,s,s,s,s,s,s,s,s,s,s,s,s,b,b,l,l,l,l,l,l,l,l,l,p,l,l,l,l,l,l,l,l,l,l,l,l,l,l,l,l,l,l,l,l,l,l,l,l,l,l,l,l,l,p,l,l,l,l,l,l,l,l,l,l,l,l,l,l,b,b,b,s,s,s,s,s,s,s,s
s,s,s,s,s,s,s,s,s,s,s,s,s,b,b,l,l,l,l,l,l,l,l,l,p,l,l,l,l,l,l,l,l,l,l,l,l,l,l,l,l,l,l,l,l,l,l,l,l,l,l,l,l,l,p,l,l,l,l,l,l,l,l,l,l,l,l,l,l,l,b,b,s,s,s,s,s,s,s,s
s,s,s,s,s,s,s,s,s,s,s,s,s,b,b,l,l,l,l,l,l,l,l,l,p,l,l,l,l,l,l,l,l,l,l,l,l,l,l,l,l,l,l,l,l,l,l,l,l,l,l,l,l,p,p,l,l,l,l,b,b,b,b,b,b,l,l,l,l,l,b,b,s,s,s,s,s,s,s,s
s,s,s,s,s,s,s,s,s,s,s,s,s,b,b,b,l,l,l,l,l,l,l,l,p,l,l,l,l,l,l,l,l,l,l,l,l,l,l,l,l,l,l,l,l,l,l,l,l,l,l,l,l,p,l,l,l,l,b,b,b,b,b,b,b,l,l,l,l,b,b,b,s,s,s,s,s,s,s,s
s,s,s,s,s,s,s,s,s,s,s,s,s,b,b,b,b,l,l,l,l,l,l,l,l,l,l,l,l,l,l,l,l,l,l,l,l,l,l,l,l,l,l,l,l,l,l,l,l,l,l,l,l,p,l,l,l,l,b,b,b,b,b,b,b,l,l,l,l,b,b,s,s,s,s,s,s,s,s,s
s,s,s,s,s,s,s,s,s,s,s,s,s,b,b,b,b,l,l,l,l,l,l,l,l,l,l,l,l,l,l,l,l,l,b,b,b,b,b,l,l,l,l,l,l,l,l,l,l,l,l,l,l,p,l,l,l,l,b,b,s,s,s,b,b,l,l,l,b,b,b,s,s,s,s,s,s,s,s,s
s,s,s,s,s,s,s,s,s,s,s,s,s,b,b,b,b,b,b,l,l,l,l,l,l,l,l,l,l,l,l,l,l,l,b,b,b,b,b,b,b,b,l,l,l,l,l,l,l,l,l,l,l,p,l,l,l,l,b,b,s,s,s,b,b,b,b,b,b,b,s,s,s,s,s,s,s,s,s,s
s,s,s,s,s,s,s,s,s,s,s,s,s,b,b,b,b,b,b,b,l,l,l,l,l,l,l,l,l,l,l,l,l,l,b,b,b,b,b,b,b,b,l,l,l,l,l,l,l,l,l,l,l,p,l,l,l,l,b,b,s,s,s,s,b,b,b,b,b,b,s,s,s,s,s,s,s,s,s,s
s,s,s,s,s,s,s,s,s,s,s,s,s,s,b,b,b,b,b,b,b,b,l,l,l,l,l,l,l,l,l,l,l,l,l,b,b,b,b,s,b,b,b,l,l,l,l,l,l,l,l,l,l,l,l,l,l,l,b,b,s,s,s,s,s,s,s,s,s,s,s,s,s,s,s,s,s,s,s,s
s,s,s,s,s,s,s,s,s,s,s,s,s,s,b,b,b,b,b,b,b,b,l,l,l,l,l,l,l,l,l,l,l,l,l,b,b,b,s,s,s,b,b,l,l,l,l,l,l,l,l,l,l,l,l,l,l,l,b,b,s,s,s,s,s,s,s,s,s,s,s,s,s,s,s,s,s,s,s,s
s,s,s,s,s,s,s,s,s,s,s,s,s,s,s,b,b,b,b,b,b,b,l,l,l,l,l,l,l,l,l,l,l,l,l,l,b,b,s,s,b,b,b,l,l,l,l,l,l,l,l,l,l,l,l,l,l,l,b,b,b,s,s,s,s,s,s,s,s,s,s,s,s,s,s,s,s,s,s,s
s,s,s,s,s,s,s,s,s,s,s,s,s,s,s,b,b,b,b,b,b,b,b,l,l,l,l,l,l,l,l,l,l,l,l,l,b,b,s,s,b,b,b,l,l,l,l,l,l,l,l,l,l,l,l,l,l,l,b,b,b,s,s,s,s,s,s,s,s,s,s,s,s,s,s,s,s,s,s,s
s,s,s,s,s,s,s,s,s,s,s,s,s,s,s,s,b,b,b,b,b,b,b,l,l,l,l,l,l,l,l,l,l,l,l,l,b,b,s,s,b,b,l,l,l,l,l,l,l,l,l,l,l,l,l,l,l,l,l,b,b,s,s,s,s,s,s,s,s,s,s,s,s,s,s,s,s,s,s,s
s,s,s,s,s,s,s,s,s,s,s,s,s,s,s,s,s,b,b,b,b,b,b,b,l,l,l,l,l,l,l,l,l,l,l,l,b,b,s,s,b,b,l,l,l,l,l,l,l,l,l,l,l,l,l,l,l,l,l,b,b,s,s,s,s,s,s,s,s,s,s,s,s,s,s,s,s,s,s,s
s,s,s,s,s,s,s,s,s,s,s,s,s,s,s,s,s,s,b,b,b,b,b,b,b,l,l,l,l,l,l,l,l,l,l,l,b,b,s,s,b,b,l,l,l,l,l,l,l,l,l,l,l,l,l,l,l,l,l,b,b,s,s,s,s,s,s,s,s,s,s,s,s,s,s,s,s,s,s,s
s,s,s,s,s,s,s,s,s,s,s,s,s,s,s,s,s,s,s,b,b,b,b,b,b,b,l,l,l,l,l,l,l,l,l,l,b,b,s,s,b,b,l,l,l,l,l,l,l,l,l,l,l,l,l,l,l,l,b,b,b,s,s,s,s,s,s,s,s,s,s,s,s,s,s,s,s,s,s,s
s,s,s,s,s,s,s,s,s,s,s,s,s,s,s,s,s,s,s,s,b,b,b,b,b,b,b,b,l,l,l,l,l,l,b,b,b,b,s,s,b,b,b,b,b,b,b,b,b,b,b,b,b,b,b,l,l,l,b,b,s,s,s,s,s,s,s,s,s,s,s,s,s,s,s,s,s,s,s,s
s,s,s,s,s,s,s,s,s,s,s,s,s,s,s,s,s,s,s,s,b,b,b,b,b,b,b,b,b,b,b,b,b,b,b,b,b,b,s,s,b,b,b,b,b,b,b,b,b,b,b,b,b,b,b,b,l,l,b,b,b,s,s,s,s,s,s,s,s,s,s,s,s,s,s,s,s,s,s,s
s,s,s,s,s,s,s,s,s,s,s,s,s,s,s,s,s,s,s,s,s,s,b,b,b,b,b,b,b,b,b,b,b,b,b,b,b,b,s,s,s,s,s,s,s,s,s,s,s,s,s,b,b,b,b,b,b,b,b,b,b,s,s,s,s,s,s,s,s,s,s,s,s,s,s,s,s,s,s,s
s,s,s,s,s,s,s,s,s,s,s,s,s,s,s,s,s,s,s,s,s,s,s,s,s,s,s,b,b,b,b,b,b,s,s,s,s,s,s,s,s,s,s,s,s,s,s,s,s,s,s,s,b,b,b,b,b,b,b,b,b,s,s,s,s,s,s,s,s,s,s,s,s,s,s,s,s,s,s,s
s,s,s,s,s,s,s,s,s,s,s,s,s,s,s,s,s,s,s,s,s,s,s,s,s,s,s,s,s,s,s,s,s,s,s,s,s,s,s,s,s,s,s,s,s,s,s,s,s,s,s,s,s,s,s,s,s,s,s,s,s,s,s,s,s,s,s,s,s,s,s,s,s,s,s,s,s,s,s,s
s,s,s,s,s,s,s,s,s,s,s,s,s,s,s,s,s,s,s,s,s,s,s,s,s,s,s,s,s,s,s,s,s,s,s,s,s,s,s,s,s,s,s,s,s,s,s,s,s,s,s,s,s,s,s,s,s,s,s,s,s,s,s,s,s,s,s,s,s,s,s,s,s,s,s,s,s,s,s,s
